{
  "atlas": {
    "1": "floor01",
    "2": "floor02",
    "3": "floor03",
    "4": "floor04",
    "5": "wallTopLeft",
    "6": "wallTop",
    "7": "wallTopRight",
    "8": "wallLeft",
    "9": "wallRight",
    "10": "wallBottomLeft",
    "11": "wallBottom",
    "12": "wallBottomRight",
    "13": "wallBottomLeft2",
    "14": "wallBottomRight2",
    "15": "wallTopLeft2",
    "16": "wallTopRight2"
  },

  "level01": {
    "background":[
                  [5, 6, 6, 6, 6, 6, 6, 7, 2, 2, 2, 5, 6, 6, 6, 6, 6, 6, 6, 7],
                  [8, 1, 1, 1, 1, 1, 1, 9, 2, 2, 2, 8, 1, 1, 1, 1, 1, 1, 1, 9],
                  [8, 1, 1, 1, 1, 1, 1, 9, 2, 2, 2, 8, 1, 1, 1, 1, 1, 1, 1, 9],
                  [8, 1, 1, 1, 1, 1, 1, 9, 2, 2, 2, 8, 1, 1, 1, 1, 1, 1, 1, 9], 
                  [10, 11, 13, 1, 1, 1, 1, 16, 6, 6, 6, 15, 1, 1, 1, 1, 1, 1, 1, 9],
                  [2, 2, 8, 1, 1, 1, 1, 1, 1, 1, 1, 1, 1, 1, 1, 1, 1, 1, 1, 9],
                  [2, 2, 8, 1, 1, 1, 1, 1, 1, 1, 1, 1, 1, 1, 1, 1, 1, 1, 1, 9],
                  [5, 6, 15, 1, 1, 1, 1, 1, 1, 1, 1, 1, 1, 1, 1, 1, 1, 1, 1, 9],
                  [8, 1, 1, 1, 1, 1, 1, 1, 1, 1, 1, 1, 1, 1, 1, 1, 1, 1, 1, 9],
                  [8, 1, 1, 1, 1, 1, 1, 1, 1, 1, 1, 1, 1, 1, 1, 1, 1, 1, 1, 9],
                  [8, 1, 1, 1, 1, 1, 1, 1, 1, 1, 1, 1, 1, 1, 1, 1, 1, 1, 1, 9],
                  [10, 11, 11, 11, 11, 13, 1, 1, 1, 1, 1, 1, 1, 1, 1, 1, 1, 1, 1, 9],
                  [2, 2, 2, 2, 2, 8, 1, 1, 1, 1, 1, 1, 1, 1, 1, 1, 1, 1, 1, 9],
                  [2, 2, 2, 2, 2, 8, 1, 1, 1, 1, 1, 1, 1, 1, 1, 1, 1, 1, 1, 9],
                  [2, 2, 2, 2, 2, 8, 1, 1, 1, 1, 1, 1, 1, 1, 1, 1, 1, 1, 1, 9],
                  [2, 2, 2, 2, 2, 10, 11, 11, 11, 11, 11, 11, 11, 11, 11, 11, 11,11 ,11 ,12]
                 ]      
  }
}