{
  "atlas": {
    "1": "floor01",
    "2": "floor02",
    "3": "floor03",
    "4": "floor04",
    "5": "wallTopLeft",
    "6": "wallTop",
    "7": "wallTopRight",
    "8": "wallLeft",
    "9": "wallRight",
    "10": "wallBottomLeft",
    "11": "wallBottom",
    "12": "wallBottomRight"
  },

  "level01": {
    "background":[
                  [5, 6, 6, 6, 6, 6, 6, 7, 2, 2, 2, 5, 6, 6, 6, 6, 6, 6, 6, 7],
                  [8, 1, 1, 1, 1, 1, 1, 9, 2, 2, 2, 8, 1, 1, 1, 1, 1, 1, 1, 9],
                  [8, 1, 1, 1, 1, 1, 1, 9, 2, 2, 2, 8, 1, 1, 1, 1, 1, 1, 1, 9],
                  [8, 1, 1, 1, 1, 1, 1, 9, 2, 2, 2, 8, 1, 1, 1, 1, 1, 1, 1, 9], 
                  [10, 11, 2, 1, 1, 1, 1, 2, 6, 6, 6, 2, 1, 1, 1, 1, 1, 1, 1, 9],
                  [2, 2, 8, 1, 1, 1, 1, 1, 1, 1, 1, 1, 1, 1, 1, 1, 1, 1, 1, 9],
                  [2, 2, 8, 1, 1, 1, 1, 1, 1, 1, 1, 1, 1, 1, 1, 1, 1, 1, 1, 9],
                  [5, 6, 2, 1, 1, 1, 1, 1, 1, 1, 1, 1, 1, 1, 1, 1, 1, 1, 1, 9],
                  [8, 1, 1, 1, 1, 1, 1, 1, 1, 1, 1, 1, 1, 1, 1, 1, 1, 1, 1, 9],
                  [8, 1, 1, 1, 1, 1, 1, 1, 1, 1, 1, 1, 1, 1, 1, 1, 1, 1, 1, 9],
                  [8, 1, 1, 1, 1, 1, 1, 1, 1, 1, 1, 1, 1, 1, 1, 1, 1, 1, 1, 9],
                  [10, 11, 11, 11, 11, 2, 1, 1, 1, 1, 1, 1, 1, 1, 1, 1, 1, 1, 1, 9],
                  [2, 2, 2, 2, 2, 8, 1, 1, 1, 1, 1, 1, 1, 1, 1, 1, 1, 1, 1, 9],
                  [2, 2, 2, 2, 2, 8, 1, 1, 1, 1, 1, 1, 1, 1, 1, 1, 1, 1, 1, 9],
                  [2, 2, 2, 2, 2, 8, 1, 1, 1, 1, 1, 1, 1, 1, 1, 1, 1, 1, 1, 9],
                  [2, 2, 2, 2, 2, 10, 11, 11, 11, 11, 11, 11, 11, 11, 11, 11, 11,11 ,11 ,12]
                 ]      
  }
}