{
  "atlas": {
    "1": "floor01",
    "2": "floor02",
    "3": "floor03",
    "4": "floor04",
    "5": "wallTopLeft",
    "6": "wallTop",
    "7": "wallTopRight",
    "8": "wallLeft",
    "9": "wallRight",
    "10": "wallBottomLeft",
    "11": "wallBottom",
    "12": "wallBottomRight"
  },

  "level01": {
    "background":[
                  [5,6,6,6,6,6,6,6,6,6,6,6,6,6,6,7],
                  [8,4,3,4,3,4,3,4,3,4,3,4,3,4,3,9],
                  [8,2,1,2,1,2,1,2,1,2,1,2,1,2,1,9],
                  [8,4,3,4,3,4,3,4,3,4,3,4,3,4,3,9],
                  [8,2,1,2,1,2,1,2,1,2,1,2,1,2,1,9],
                  [8,4,3,4,3,4,3,4,3,4,3,4,3,4,3,9],
                  [8,2,1,2,1,2,1,2,1,2,1,2,1,2,1,9],
                  [8,4,3,4,3,4,3,4,3,4,3,4,3,4,3,9],
                  [8,2,1,2,1,2,1,2,1,2,1,2,1,2,1,9],
                  [8,4,3,4,3,4,3,4,3,4,3,4,3,4,3,9],
                  [8,2,1,2,1,2,1,2,1,2,1,2,1,2,1,9],
                  [10,11,11,11,11,11,11,11,11,11,11,11,11,11,11,12]]
  }
}